peptide	lca
LPGQQHGTPSAK	Veillonella
ELPGLAALTDK	Bacteria
ELADASVSTIEIER	Bacteria
QISAGELR	Bacteria
VPAILADATK	Granulicatella adiacens
TVAWYDNEMSYTAQLVR	Bacteria
NYLSPIFTPINER	Streptococcus gordonii
YHGLTDVEIR	Bacteria
IGVTYGPTTTTTGGK	Fusobacterium
TLLNDGQVVVAAGGGGIPVIK	Streptococcus gordonii
VPIVLDVFAER	Streptococcus gordonii
TVVWNGPMGVFELPNFAK	Granulicatella
YGAQIINMSDK	Streptococcus gordonii
LNEIGAHYGVGVVDIVENR	Veillonella
AANVSLLNIETVK	Streptococcus
ASGKPSLIEVK	Bacteria
GDAVETDAVLIVLK	Fusobacterium
VLTAAMINNYVK	Streptococcus
GIEVTLPFPR	Bacteria
ALGGDMQAR	Bacteria
IPVLADKEK	root
TVAVGQPDQFKK	Streptococcus
EQNPDVHVVAVEPADSPVLSNGKPGPHK	Veillonella
FQAAAGQLEQTGR	Streptococcus
AQIAEYNK	Bacteria
GMQDTEGAANLIQTQFQEGK	Bacteria
KLDSVELEDLGTAR	Veillonella
AAFGDDDVYVEK	Veillonella
SYIWVVDESK	Streptococcus gordonii
LGEFNLEGIPAAPR	Fusobacteriales
EVSLLELTVAGTK	Streptococcus
IQASPIVNEFFTK	Streptococcus parasanguinis
ESVLSTGEPILK	Veillonella
VALLKPYQVNMDLVK	Streptococcus
LVQTLTDK	root
AKPGITTLELDTIAEEYIR	Veillonella
EGLYHIVNVEANDDAALKEFDR	Bacteria
NIITQSIGQK	Bacteria
EGAIISPIFMLTK	Fusobacterium
GPGLEEGLK	root
LITIGGAPYSTLR	Bacteria
ILALVPEEWIK	Firmicutes
SVLPVVLDAGTNR	Bacteria
MKDFAELLAAEGQEEFKK	Veillonella
EGADAIVVEGMEAGGHIGK	Granulicatella adiacens
IGLASPEQILSWSHGEVK	Veillonella
QGTNAVHGAPLGADETAATR	Bacteria
NMSIAQQADEVR	Bacteria
FLDTNHVEYR	Bacteria
AAVVGDTVGDPFK	root
TAEFIGEYFR	Fusobacterium
VMFPGWYGVGSSFK	Bacteria
IEPGAIIR	root
DKEGTFHYSWYDEK	Bacteria
DVSHIPTAVK	Haemophilus parainfluenzae
FAALVVVGDR	Bacteria
IGVIQLVEHPSLDAANK	Veillonella
SPNPESQAAFALAEELGR	Bacteria
AGISIAELER	Bacteria
ATVGVVGNEQHGLVNLGK	Bacteria
DYSSIDAAPEER	Bacteria
SAQDLVTATLTGDKK	Streptococcus gordonii
YDLAAVGR	Bacteria
VAMLSYSTK	root
IVDTIPIVNK	Fusobacteriales
YGLIAFASSLDQIGPVTR	Bacteria
NGIIHTTIGK	root
SEEDVLSYALFPQVAK	Bacteria
EAAIFSSK	Fusobacterium
SGEVVEFDPDKIYQAVLK	Streptococcus
NISTVNAQPTK	Bacteria
YIPTYSHNQNIR	Fusobacterium periodonticum
IIDGAFADYTGK	Bacteria
ALVDKYVDEAR	Fusobacterium periodonticum
HQRPTNELPQGGIIEK	Bacteria
DNGEVVVGEIAK	Fusobacterium
GEVIEANEGYRPSSEIK	Granulicatella adiacens
LEVGEGIEKKEEDFAAEVAK	Bacteria
EDVTDIILNLK	Bacteria
GSVPGAINGDVIVKPAVK	Bacteria
HTDSETGVGR	Gammaproteobacteria
SVLEVAGVR	Haemophilus parainfluenzae
NVASVDFR	Granulicatella adiacens
QFYTYEEVPHK	Veillonella
KGDIVSAGSK	Fusobacterium
IAVVGNKPGVTK	Bacteria
SPLTPWGKPALGIK	Fusobacterium
KGHVPAHIIEQR	Bacteria
FINVIMVDGK	Bacteria
KIAEEIQAK	Veillonella
LREEIEDNPSDSK	Bacteria
ETVEGASLGLPGVLSAEVDLPEK	Veillonella
NFGMANPEGYRK	root
SASTVGEVASIFAK	Streptococcus gordonii
GDILIDGGNTFYK	root
YNAAQPIQGVTAK	Granulicatella adiacens
NGQVELQGNDFELGIR	Veillonella
ELETLTDNAEEVLR	Veillonella
VLPNFKENLEK	Streptococcus gordonii
SLLTLADVMPTGYHAAR	Bacteria
WIYSFEEGSANDK	Streptococcus
FGFIELNDGSFFK	Bacteria
EYADYLHEDLAIR	Bacteria
GPTITGIIGPNGAGK	Lactobacillales
DISYNVIR	Veillonella
DVTNLGNTGYFSEVNPVFTSVPEGVK	Veillonella
HVGLPEPDFGFSPDAEFPIINGEK	Bacteria
NWSLFGTEDLESADYR	Lactobacillales
LESMASDGGSLKR	Streptococcus gordonii
LAAESLTSPEIR	Streptococcus
IQNVEGVEVTR	Bacteria
NNQVQQEIDLLVEK	Granulicatella adiacens
TTDVTGTIELPEGVEMVMPGDNIK	root
IVSGPEADIK	Bacteria
VVAEVVAQGR	Bacteria
LKELFEQDAANNGGTR	Veillonella
IVTAYDAAQLINPNDK	Veillonella
EFPGIMDR	Bacteria
VVDLIAPYVK	Bacteria
VLPGFDENAK	Bacteria
VTPTSTDATSNGIQGQPQK	Bacteria
ITSEYLDFDEVWEK	Fusobacterium periodonticum
SIIGLDNNGMVIPVQVIK	Veillonella
VGQQAPDFTVLSNDLQAK	Veillonella
TKEVLNIINSFNVGDAK	Veillonella
VIGHYQDMVK	Streptococcus gordonii
IAAENVYPK	Fusobacterium
GAEVSLCEVWAK	Fusobacterium
QSGGAGQYGDVFIR	Bacteria
IADNAFYR	Fusobacterium
AFAVLLEEEVR	Bacteria
VAQIEVVR	Bacteria
RPIITEASMLATDEKK	Granulicatella
DLAVSPFAPTVLDK	Bacteria
GVLTFTISQEQIKPELDR	Streptococcus
EASALSTQDGDKK	Veillonella
EYIPLLIFGK	Streptococcus
IVTDSSVTIEPEVVK	Bacteria
LANELSDASDNKGAAVK	Bacteria
ILNPDVIITDDPDVYKK	Veillonella
REDGDIGLLEVK	Bacteria
GQHVVVIANHLK	Streptococcus gordonii
IEGQKPLIITTSAR	Fusobacterium
LFNELGPR	root
FANDFVNDYK	Bacteria
HQYGNTIGR	Bacteria
VASLADIDDEIFK	Streptococcus
TYTYDLPAYTNGYQVK	Veillonella
HFSPEFAFESAAVLAK	Bacteria
SEIQEALTAYAK	Granulicatella adiacens
AANVTLIGK	Bacteria
SALDAIDILEFTNK	Fusobacterium
ILMLAAEHILNPK	Bacteria
YLIDLYQK	Bacteria
ITVTLIHEMK	Bacteria
LLQAADFNIER	Bacteria
LAIIQLGTYDGTIYNAR	Bacteria
TLLDPFAGK	Veillonella
YEILYIIRPNIDEAAK	Granulicatella
VWKPNLQVTTLNVNGSPIK	Fusobacterium periodonticum
VIFEANPYYYK	Bacteria
VYVVEFFGK	Fusobacterium
AHIYFINSEEPSQLNELQEFR	Bacteria
ISTIETAR	Bacteria
VVPISGDVSDFADAK	Bacteria
VNLDVLQK	root
GMVSGMIDR	Fusobacterium
IHPTAGVTAVGVR	Lactobacillales
QLREPELNDEFAK	Fusobacterium periodonticum
SIDAVAATLEEEDEKVKEK	Fusobacterium periodonticum
ATLGFAPDSSFPLTYAEK	Streptococcus gordonii
VEIGVIAVK	Fusobacterium
FLPAYQER	Streptococcus gordonii
AGDYPDIVMLALGR	Bacteria
ALLQGVLDR	Bacteria
IIGNEFVYVFDDEASK	Bacteria
TNEVPANTEAR	Streptococcus
DAAANDAIILFVGTK	Streptococcus gordonii
AAFIEENRK	Bacteria
EFDTTLDLTK	Fusobacterium
GALSAVIADSR	Bacteria
SEDYLIQVIR	Granulicatella adiacens
SKPTPLLEQEIR	Bacteria
NAQTLLNEYGR	Bacteria
AVMAAQGSILTNK	Bacteria
NVYGFNADANFDK	Veillonella
KNLIEVPMVGTTIPHEVLSEFGGAK	Bacteria
VNVVGGGNSGQAGAIR	Fusobacterium
DIIGEDAVK	Fusobacterium
EWGVALPLHPEYR	Veillonella
GIGMGSPGVVDR	Bacteria
NGVHIINLEK	Bacteria
DSFDIELTSAGDK	Streptococcus parasanguinis
ATDLHIQNVLK	Veillonella
FDENAAVIIR	root
QVGVQYIVVFLNK	Bacteria
VGAATETELKEK	root
TEDPVQIVK	Veillonella
AGDIAAAIGLK	root
TAGDKDGVTPVLQK	Pasteurellaceae
GKLEEHGLLR	Bacteria
INIVDTPGHADFGGEVER	root
NDQDVHYETLQSETLK	Granulicatella adiacens
QLALDMFGNK	Firmicutes
KLTELGIEEK	Lactobacillales
AVGLIDVPVK	Bacteria
MVTFVAGTK	Bacteria
TSSETVVWEDGNEYPLLR	Granulicatella adiacens
IVECIPNYSEGKDLAK	Fusobacterium
FVQMFSEIAK	Fusobacterium
VTIQNLEVVQVVPEK	Bacteria
DDAPVGTLAVDSIYTPVTK	Streptococcus
TNDTELGFQAGVIGHVPLTNK	Veillonella
AVFVLDTDNVIR	Bacteria
VTIVTNSIHHASK	Streptococcus gordonii
LVANLTVLYTK	Bacteria
ALQAAGLEVTSIK	Firmicutes
YIGIPTTSGTGSEVTPFAVISDKK	Bacteria
DGSIIDVIKK	Bacteria
VNEENPFVAVR	Veillonella
RLDEFEALVEK	Bacteria
SALDAIDILEFTNKK	Fusobacterium
LIDDGEEVTAK	Bacteria
IAYYLLNILK	Bacteria
FEDEFSPELYNIR	Bacteria
LEVIAHPLIQHK	Streptococcus
ISNGVGVER	root
VVAPGTPADMK	Bacteria
NTSEFIKPFEEIK	Fusobacterium periodonticum
GNVVEGTVVQVEDER	Veillonella
SWDEVPEK	Bacteria
MIELISLIAK	Veillonella
DTLAGPWDNIEER	Carnobacteriaceae
ISVLSIVQR	Veillonella
EIPLFVNAVVTK	Granulicatella adiacens
ASFVSNNEVK	Fusobacterium
LIFENAELVK	Fusobacterium periodonticum
TISVTLSGVDGAEQIK	Bacteria
ELVNCFYEGAK	Fusobacterium
VSLTGDPIHEIEVGR	Veillonella
GVFNMTQAVSR	Fusobacterium
DPFATIGNAVSLNHMYADTR	Streptococcus
TVIGYGSPNK	root
ILNALQVLAQVSVHR	Granulicatella
FSDVAGAEEEKQELVEVVEFLKDPK	Bacteria
YDSVHGTIPNEVTFDEENIYVDGKK	Veillonella
TSFDWGIK	Bacteria
LTTPPSNVLK	Lactobacillales
CVGELLQNQFR	Firmicutes
DNQLHVALK	Veillonella
TGRPAVETVFTVLHAGGK	Bacteria
LKVPEGILK	Streptococcus
YGLAVDPSAK	Firmicutes
ELEQAEADYNLEK	Granulicatella adiacens
EIVAFPGESAEEKDHVK	Veillonella
LLDEAAAEK	Streptococcus gordonii
LDLPSGVNVEIK	Bacteria
SKEVSSSVGGGAVSVK	Fusobacterium
LGVADDGDLTGK	Streptococcus
DTLYGQIDSVASGQK	Granulicatella adiacens
SDAFFLGR	Veillonella
KHIPVHVTEQMVGHK	Fusobacteriales
TAAIMYSNNNDQMVSVNNTAR	Veillonella
VVGSIVSTQK	Veillonella dispar
GVYFFDYGNSFLK	Bacteria
ESDPYTVVNGVMTSVLK	Veillonella
LGAVDGMVAGSACPTANVLR	Veillonella
TADSGYLTR	root
TPAEQVEYLAELVEK	Granulicatella
VNPVVPEVVNQVCFK	root
TSTFLDIYVQR	Granulicatella adiacens
LPLPGLQLEDRQ	Veillonella
ISNESPIGHALIGK	Streptococcus
VTVVATGVR	Bacteria
ELFGNRPEPVFPLLTK	Bacteria
EAQEQGLPIAVK	Streptococcus
QQMNALYVIHK	Bacteria
TVVQHQVAK	Bacteria
MSEFVTLCSR	Bacteria
LNTGLTADCTK	Clostridia
TPEPIAALEK	Streptococcus
AVFNNMVVGVTDGFQK	Granulicatella adiacens
LTTLVENVEK	Veillonella
LIEISIPIK	Bacteria
DVDPHFYGEEPLEK	Fusobacterium
IWGNIAEQIDEINQAHTNTR	Streptococcus gordonii
ESGAHILITEDADEAVK	Streptococcus
HLVDEPQNLIK	Pecora
LKVPEGALK	Bacteria
LVQLGIYPAVDPLASSSR	Bacteria
APVTLGHEFSGEIVEVGSDVTR	Streptococcus
EVLDMYKEYGVK	Fusobacterium
KAIVDGLADSIK	Bacteria
LTGGGADVSYEVTGVPVVLGQALAAVHK	Streptococcus
NMLVAAEK	Bacteria
LLVLGGFLASDDKGK	Fusobacterium periodonticum
LVNSGTEATMSALR	Bacteria
IINEPTAAALAYGVDKDEDGK	Veillonella
VNELYAAAK	Bacteria
RADSVANYLVAK	Pasteurellaceae
DAPQTLINVK	Fusobacterium
NEVDQAIFATEK	Bacteria
ALEEIESGNVTIHPDPEGKR	Bacteria
EPFLLPPFAGK	Veillonella
VNAIYEQEEK	Veillonella
GLLIVFSGPSGVGK	Bacteria
VNHWVAQGASLSDR	Bacteria
MDPAIVAK	Fusobacterium
VTVEMSPYDLTR	Bacteria
ADLEYPLQNKR	Bacteria
ASAVDEAFSHDTAQYSK	Lactobacillales
FAPLGDPVEIK	Bacteria
GPMAHGSR	root
FEDETVALK	Bacteria
EMSDDAPFASLAFK	Fusobacterium
QSIESSLGTDNVVVDIHQMK	Streptococcus gordonii
FLKPGFEAITAAVEER	Streptococcus
VSAAILLNLLR	Bacteria
KGDPDPETNTALK	Streptococcus
VVAVGLPSEMMDLSIVK	Bacteria
VEDVATINKKPITK	Fusobacterium
NILQLAEYLSDK	Granulicatella adiacens
LIEPEYVKPIQGLK	Streptococcus
ATAHEVAK	Bacteria
FADEFLADSK	Bacteria
GVATISEVAGEVVSIEENAGSR	Granulicatella adiacens
NQIAIAMTLLR	Bacteria
ELLTQFGMPFEK	Veillonella
IPFASTFAMFAAGR	Bacteria
GGITVDPSELSQR	Bacteria
TKPETSTDISVK	Veillonella
HHNTYVTNVNAALAK	Streptococcus
ALLAEAGFPNGFK	Bacteria
IIPNPEGNR	Bacteria
TMLNLVRPEYFIPVHGEYR	Veillonella
NPQTGAEIK	root
VQITGDAYQPYVLYK	Granulicatella adiacens
VPIVLDIYAER	Bacteria
VAQNLLDEVNITLNK	Bacteria
DGALPVEVSADDLNK	Streptococcus
GLSQEELAKR	root
LLDYAEAGDNIGTLLR	Firmicutes
AWEGTPIEGGFR	Streptococcus
YYTTDGYTK	Veillonella
FQLLHESLK	Bacteria
EVSSSVGGGAVSVK	Fusobacterium
VDTTSPLFK	Veillonella
SENPTAEEIAAWYPQSGK	Veillonella
ATVNPVDQHVVTLTIEVPAAEVDK	Veillonella
YGVEGIGTR	Fusobacteriales
STVTIGLTQALNK	Fusobacterium
AYGGSSMAFGNNAK	Veillonella parvula
ELVDGAPNVIK	Streptococcus
LSLRDPQDTHK	Bacteria
IIDPTSVNK	Bacteria
YAIQTPYDIVVLSGK	Fusobacterium
LYNLPVNDEVEAIK	Streptococcus gordonii
TGILMSEAVR	Veillonella
FSTDALVADFNALK	Fusobacterium periodonticum
QAEAELFETQK	Streptococcus
TLHVAAVHGTGNLRK	Veillonella
FGVIVASGIGGIK	Bacteria
KIDEMGGAVVAIEK	Firmicutes
ALLQVDPDFR	Bacteria
VLAHPASVDSIPTSANQEDHVSMGSIAAK	Fusobacterium
YLDPEFTDILEEDLRER	Granulicatella
WGISAEIR	Fusobacterium
ALLDVDGELR	Veillonella
AILIDDILNTGR	Bacteria
APDLNAADVEAAMR	Granulicatella
VLADVGLVGFPSVGK	root
MEPDAILR	Fusobacterium
SLADQMVTLAK	Veillonella
ATHITHLSK	Bacteria
INCLSLPISETAMK	Veillonella
SSTPYLVAFDALR	Veillonella
ENLAGLPAAIR	Bacteria
ELGHEFGTVTGRPR	Veillonella
VYGEDGGQMPPHDADALTTYIR	Bacteria
SIVSTDLVTK	Bacteria
MADAIIEGR	Bacteria
LITGPTGK	Fusobacterium
VVPIISIGTK	Veillonella
EPSLGPVFGIK	root
FGLIPELIGR	root
ALEAVWNIISR	Bacteria
SIVTQVVESGFK	Streptococcus
GTTAEYYFSK	Fusobacterium
VVSWYDNEWGYSER	Bacteria
YSAAELQK	Bacteria
NCTVGVVGLGR	Bacteria
VICNNCNLPYDHR	Veillonella
IIVCHLGNGASITAVK	Fusobacteriales
TNLVLEQIVK	Granulicatella
ESELQEIVR	root
AQVEETSSDFDREK	Veillonella
ILHDETIQVVPTTVR	Veillonella
AIDALVPIGR	root
FVSEYGLSR	Veillonella
TAAEQIDYLEELVNK	root
QALIDYLTPLK	Bacteria
DAAANDAIILFVGTKK	Streptococcus gordonii
FVEKPSPEEAPSDLAIIGR	Lactobacillales
DNMENIQAK	Veillonella
QSLENIGAILK	Fusobacterium
GLDVGAIEYIHK	root
SGILGGTFQEMLR	Veillonella
NTPLQMLLR	root
LQSSVFPANQGGPLVHIIAAK	Bacteria
AAYHLLGLGTYFTAGEK	Bacteria
MLSPQSIAISIGAVGPALK	Veillonella
TLTGELVAPSVK	Streptococcus gordonii
MLAEGVEYK	Veillonella
AGYTAVVSHR	root
TDIDLPWEK	root
GLCGSFNSSTLK	Fusobacterium
GEGLENPNLK	Bacteria
QATIDAVSYLLK	Bacteria
NGDNFDVVIPSR	Streptococcus
FKGEEAVCDIDALPEELK	Veillonella
INMVTQAAFFK	Veillonella
SAAIMIGYLGNFTK	Veillonella
DVLPDPIYNSK	Bacteria
AVNIGFDNISLNK	Streptococcus gordonii
EEINEAFR	Bacteria
VFSEAPAVK	Bacteria
SQDYVVLDDEVVNAYIEK	Haemophilus parainfluenzae
IAPALKDGK	Bacteria
VIAYLNNEHAIEHATGLDTYER	Veillonella
AYEEANPNVK	Bacteria
AGQLTPEEAETHPQK	Bacteria
ADSEWNVVLLR	Bacteria
SIVEGILSIIK	Fusobacterium
AAGSQIFGETVYASLK	Streptococcus
LVAEVASK	root
EYDVEGNLLK	Fusobacterium
TTVTGVEMFR	root
AAESILFEIVR	Bacteria
VTDFHLDNLDAK	Bacteria
KNVIIPELAEDLDGLGYLQGK	Streptococcus
DGVISALAFDQR	Streptococcus
EIPNVSESALR	Fusobacterium
VMSLHDAIAK	Fusobacterium
NTEAGVGFNALTEEYIDMVK	Veillonella
VPEGLDPAQASSITCAGVTTYK	Bacteria
AGVPVIPGSDGEVHTAEEALAVAEK	Bacteria
GQIDPVTEQLLLGTINK	Veillonella
IGADFLYSVSTLHDR	root
KGNVILLEPTIAEAVSR	Bacteria
ILLGESDDSIR	Veillonella atypica
AGVLSEVR	Bacteria
LVKPCQSVAILGSAGK	Fusobacteriales
LLNEPILLLHK	Veillonella
TVVALGLGK	Bacteria
ADATGNVVITQADK	Veillonella
VAGDYTHHGNFQGTK	Haemophilus parainfluenzae
LIDIVNPTQK	Bacteria
VYLDKPGGVDLDDCQLVSEK	Veillonella
ILVINCGSSSLK	Bacteria
FVAVDSLSFTAPK	Streptococcus
LFDDNSFVELDQFVK	Veillonella
VAVVSDSPFR	Fusobacterium periodonticum
LAGGVVDEVSK	Fusobacterium
ESPALGFIFNTEPVK	Streptococcus gordonii
IPEHFANVDK	Bacteria
TGVWTGAYAINPVNGK	Bacteria
ALAQLNPEIEAFYQK	Bacteria
SVPGNEMTIEGECR	Granulicatella adiacens
AMAYAIDNDAIGEQFHHGLATTAK	Fusobacterium periodonticum
VQEAAEILGLK	Bacteria
LILADNEEEIK	Streptococcus gordonii
GDDHIANTPK	root
NFLQSSDLK	Streptococcus gordonii
QVIDVDLNAPFIVSK	Bacteria
RDDAPVGTLAVDSIYTPVTK	Streptococcus gordonii
IAHIWIQDGMPSDIER	Veillonella
TPTELVDYIIK	Fusobacterium periodonticum
IDLFFLNK	Bacteria
LVGGAGEATIIAR	Bacteria
IFELAAALDSYIPTPQR	Eikenella corrodens
ALLNNMVVGVSEGFKK	Bacteria
AQIALLMQQAGLTK	Veillonella
GGTFLHSAR	Bacteria
GMVPSGASTGEHEAVELR	root
GEDLDLIYTNPK	Veillonella
NEALGTDNLKDK	Fusobacterium periodonticum
FDDNFIALFR	Fusobacteriales
HGATCEIDQEAKK	Streptococcus
VVVALGGNALGNSLPEQK	Veillonella
NKNEYSYYTFPK	Veillonella
FLDVVDSNSPAPGGGSVSALASSLGASLAR	Fusobacterium
VPLFIEVDDVLR	Veillonella
VTLYDGSYHEVDSSEMAFK	Bacteria
IGVPAAIQVAR	Bacteria
IGNKPVVIPAGVTVDLK	Granulicatella adiacens
LTEALPGFPIVLHGGSGIPDDQIQAAIK	Firmicutes
KVFVHLAK	Bacteria
ITNVAPGEISSTSTDAVNGSQLNR	Veillonella
VTIFPLEVIVR	Bacteria
EFIPAVEK	root
LLGDMVALITGK	Fusobacterium
EADNVIYTLAGPEISVASTK	Fusobacterium
GLNTTLHLK	Granulicatella adiacens
AAEFIQENTK	Bacteria
NEEFKEFGR	Fusobacterium
NALNLLFSK	Bacteria
IPELTNSER	Granulicatella adiacens
TAAIIDGPWK	Bacteria
NAQLVVETSEK	Granulicatella adiacens
DIFEQEFGR	Bacteria
KEEVLEEIYK	Veillonella
IVEGASHSSK	Streptococcus
STAPALQESPQK	Veillonella
MFGTSYSDR	Bacteria
TMGLINHVSR	Fusobacterium
AQEANQNTQAQLNQAK	Streptococcus gordonii
VATELYDIER	Veillonella dispar
TSTLQQLASSYLGFSASK	root
ADDLVEVGK	Streptococcus
VLAFEFANNR	Bacteria
ALTEDEVVK	Bacteria
SGVLGISGVSNDFR	root
KTVEAVQAGAVEEAK	Firmicutes
GNVEGWVSVVRPGR	Fusobacterium
TQFVAEEIASLK	Veillonella
NKPTFTPNVDTGDFVIIINADK	Lactobacillales
IVQSLKDDIK	Fusobacterium periodonticum
NGDDFDVVIPSR	Bacteria
AQVDAGNMPHDR	Fusobacterium
FHAGNNMGIGK	Bacteria
IFSGSSNLELAK	Fusobacterium
NSAVPLLDKR	Bacteria
IEYVPFPEVLK	Veillonella
TPMLEAFR	Bacteria
LDENGDPTLEVNDK	Bacteria
IGLGNIPR	Bacteria
NGTPVTATYSPEFTK	Bacteria
MVYLIGWTK	Veillonella
AVVVSLDEAK	Fusobacterium
NAIANQDTEDKVEFYPPR	Bacteria
DHDKELFEAK	Veillonella
GGSPIAASVCNALLYTDVK	Bacteria
IAVFMGGTSSEK	Fusobacterium
ISGTAECPR	Bacteria
YNGTRPAK	Bacteria
FMTVSAFDEITASKPEK	Veillonella
IVEFEEKPENPK	Bacteria
ETTYILNHFGFAHPQVVK	Veillonella parvula
ITALIGPSGSGK	root
FAALVVVGDHNGHVGFGTGK	Lactobacillales
FFVAPFPEVFGK	Bovinae
YMPDATKK	Veillonella
HTVFGQLLDEQSYQVLDK	Streptococcus gordonii
GQDWTLTAAVVTKPEVK	Streptococcus parasanguinis
LGLALTELMESK	Veillonella
MNLYDVIK	Bacteria
LSLATPILANLR	Fusobacterium
TITAMAPAER	Veillonella
GALTVAGFNLAK	Streptococcus gordonii
ALNGATNPVDAAPGSIR	Veillonella
AINEFNPELAR	Veillonella
VSQVVGAK	Firmicutes
ETLIDFYNEYKK	Fusobacterium periodonticum
LATPPGVK	Bacteria
AEGENATAIGHGSVSSGR	Veillonella
KEEQLDSLTGE	Firmicutes
DIDIMPFEITK	Pasteurellaceae
FDLLVADLNK	Veillonella
HTPFFNNYRPQ	Polaromonas
DVLPDPVYNSK	Bacteria
ITMYGEGNASK	Streptococcus
NDEPGYYSVLLVR	Fusobacterium periodonticum
KNESLDDALR	Bacteria
LTVTELKPFHSTEIYR	Bacteria
EVWDIIAK	Veillonella
HINTIAVLEVDQVK	Streptococcus
AANHQEIGR	Proteobacteria
FQVVEAAK	Bacteria
IVGEADIIITPK	Veillonella
FNVTVNGTAYDVEVNEVK	Veillonella
VVLTGFDVENIVR	Streptococcus
VVTLLDKPER	Firmicutes
DFLEIETPMLTK	Bacteria
NPSVSYGWSAQK	Veillonella
EGMPIGAK	root
AIGPYVQGK	root
VTPGDVLTLQVDIVK	Granulicatella adiacens
LTIVHVIDTR	Bacteria
DLWAFVQR	Bacteria
HTPFFNNYRPQFY	Streptococcus uberis
NAGKDDEWGMQTFAK	Bacteria
TQTSGVQIR	root
LFSAVSLGGLLK	Fusobacterium
TEAEKLEATR	Fusobacterium periodonticum
ENVYDLEWTK	Fusobacteriales
AFEAEAAAK	Fusobacterium
ALAAAGLEVTAIR	Bacteria
GYGDPDGYFGTSTK	Veillonella
AAQEHGLK	Bacteria
NFDEVQETLIK	Veillonella
IGIGPITK	Streptococcus
VSNESPIGR	Bacteria
QAVPLIDPK	Bacteria
ITLDNLFSTLK	Granulicatella
TRQDSLTEFEK	Veillonella
TINVIIPYYGYAR	Fusobacterium
AYVQTMHQNYK	Fusobacterium periodonticum
YDAVYANEADNATGGK	Veillonella
TGILDVIQAMGGK	Streptococcus
STLFNAITK	root
FTETGSMK	Veillonella
TSLLDTAEQEVEK	Veillonella
PGSINPHTK	Gammaproteobacteria
TVNMQIDTNEPGR	Streptococcus
NPIFVGILK	Bacteria
LNDAESWEIIK	Streptococcus gordonii
TATADQAEEVCK	Firmicutes
DGEILLQEDANELR	Streptococcus gordonii
YFGTDGVR	root
ADLNVPVK	root
ISFMGIPTPNIFTGVENLHGR	Veillonella
IQLFEGVVIK	Bacteria
EKTGQEGYDVFK	Fusobacteriaceae
LPVFSGSGLPHK	Bacteria
GFVLVDAGLK	Bacteria
SASTVGEAAGIFAK	Streptococcus
HTNHGAHLSLK	Bacteria
LGIMGIPIPK	Porphyromonas
TTTEIRPLDAQINVLPIPHGSALFTR	Fusobacterium
EGEISPDGQGVLNFAR	Bacteria
IVLPEGEEPR	Bacteria
YPEFAQLEGQLK	Bacteria
VMLVAADTFR	Bacteria
DFDFEYLSK	Lactobacillales
FAYTAILFR	Veillonella
SAGQKPQVAITLPLLVGLDGEKK	Pasteurellaceae
QFFIGEHEDK	Bacteria
VDCNVGKPQVAYR	Bacteria
EITDIDVENVVR	Streptococcus gordonii
TLNGDLVAPSVKPGDR	Streptococcus
NKDHVNIGTIGHVDHGK	Mycoplasma fermentans
FIQVDIDPYK	Bacteria
DGANAFTEASDADKK	Veillonella
ATVMTGLTTGHPVR	Veillonella
ETSITPVLLGNPEK	Bacteria
HEDLVATDHAAMEVIDPNRR	Streptococcus
FTLDEGLSK	Bacteria
TQSASDIMSQAPSEVEPK	Veillonella
AAASIVVVDSR	Bacteria
SINTACASSNDAIGDAFR	Bacteria
TVKDTVEYIDSAK	Veillonella
VLVAQAAGGLADYLK	Pasteurellaceae
ELCTEHGVTADWFK	Fusobacterium
NNTIPHEITGR	Fusobacterium periodonticum
KLVQLGIYPAVDPLASSSR	Bacteria
EILYVPAESIDAVK	Fusobacterium
EEAATIVETAK	Streptococcus
MQAAGAEAYLVNTGWNGTGK	Bacteria
LVELLNKDVTPWIPEK	Fusobacterium
VNQDWDINAGYR	Veillonella
EDVDGIPSLVFFR	Firmicutes
IVNEVDHVNR	root
NMSAAEMEQK	Veillonella
MIAGLEDISEGELK	Bacteria
VGTAIFGER	root
SQNGAAMSFGR	root
FVIEPLER	Bacteria
KGDDVVQLNYK	Fusobacterium
SFSTPVINTLAELGVK	Bacteria
NYFYPDNPK	Bacteria
TSNTCDVVLEDCR	Bacteria
SLVIHPASTTHAQLNEEQQK	Veillonella
LHHLVDDK	root
GYGTTLGNSLR	root
IVHGSQEDKDK	Streptococcus
LLGTDRPK	root
VVFVENYR	Bacteria
VMHIAEILNCR	Veillonella
IASEIGLGGR	Bacteria
IEFSAPNYAK	Fusobacterium
VKETILAAAK	Streptococcus
STVVGHAGK	root
NTQNNTPAIIYTEIVPGDK	Veillonella
PHVNIGTIGHVDHGK	Veillonella
LVIPALTEETR	Bacteria
FAVTGTGEFKR	Veillonella
FDENAAVVIKDDKTPR	Firmicutes
GFIPASMIDTR	Bacteria
LFSGILDKLNLLGEDGK	Proteobacteria
AQVPLAEMADYVTALR	Veillonella dispar
TIMTEQGEALMGIGVGEGENR	Veillonella
DLNLSYGGNVAAAK	Veillonella
YQDLAAFGHIGR	Bacteria
EVAEDAKEAVEGAIK	Streptococcus parasanguinis
TTETSALLDR	Bacteria
YTTHTMLR	Fusobacterium
VGDSVLITGK	Veillonella
ALLLADESLK	Fusobacterium
EMAAAYCK	Bacteria
DTEKPLLLPVEDVFSITGR	Bacteria
QILMVAGYEK	Bacteria
FNAVIEFSHLK	Streptococcus
IMETRPLSATK	root
SALPVLSDDNVLLGEITER	Fusobacterium periodonticum
ATLEDLGQAK	root
MINFNNVK	Fusobacterium
KGDPDPESNTALK	Bacteria
MGQDPMEVFDQALK	Veillonella
LPDAVIVEGPK	Bacteria
IVTSDEFNSQVAAVNER	Veillonella
FEGNTVSADSTLR	Bacteria
IIEIYGPESSGK	root
VVIAPQFR	Veillonella
GQDWTISAEVVTKPEVK	Streptococcus gordonii
FNLGQLSIYANQEKPAAPK	Streptococcus
IATDPFVGNLTFFR	root
AWEGFKGEDWK	Lactobacillales
IVAILLDTK	root
FVNVVDLLK	Bacteria
KPFIAGNWK	root
TVETDGYNAVQVGFDDLR	Streptococcus
GVNPAQQFIK	Fusobacterium
GNSGVITSQLFR	Bacteria
FHHSMLDK	Streptococcus gordonii
ITLEDLINVTR	Fusobacterium
QTNVTAGEAGGITQHIGAYQVR	Veillonella
VVTIIGNANPSDK	Streptococcus
EISFLQAENER	Granulicatella adiacens
GFNNSVFAK	Veillonella
AGGNYLSSQLIR	Fusobacterium
VALTGLTVAENFR	root
SSNYASVEK	Streptococcus gordonii
EHNATHIQIIPK	Granulicatella adiacens
FPEGVLLVGILR	Veillonella
ATFIINGAER	Bacteria
RLAEASGPIFDVEETR	Veillonella parvula
IGVTANVGYDTK	Fusobacterium
FEASEEELKER	Fusobacterium periodonticum
IVSGHNLPMR	Fusobacterium
IGGNAVADIIIFGR	Bacteria
ELQAIIDEAWKNPEFQAASKN	Bacteria
TLEADIADAK	Veillonella
EGVEDFVR	root
GPNTGGSQFFIVYEPQPHLDGVHTVFGK	Negativicutes
TSGAFLMVR	Bacteria
KFGNIGDVIVASVK	Firmicutes
VTIAANGK	Bacteria
KNLIEVPTSGSTIPHEVIGR	Granulicatella
FAASDLNDLYR	root
KVIEPEEQK	Bacteria
ENGDDIPEVQNWK	Streptococcus
YVALHDAYLSVVEALDHAGIATGTK	Veillonella
FKLEYPLFNK	Fusobacterium
QNNTSFIQSVVAK	Streptococcus gordonii
SSLPAFPK	Streptococcus
TITIAASK	Firmicutes
GVFYPTPDTEVPFTK	Firmicutes
ALQEAVNK	root
WQLYLMPEEK	Lactobacillales
TAAFGLPVLER	root
EPGVLHEVDAK	Fusobacterium
EASPEAVAEAK	Streptococcus gordonii
AMVATGIDFLAAGIGNIHGPYPANWK	Streptococcus
VQALEIDTMDMHECEK	Fusobacterium
FNFSHGDHQEQGER	Bacteria
ELFGDHAK	Bacteria
LIEAGANTFR	Bacteria
LINRDELSHVVLFR	Bacteria
FVETTPDK	Veillonella
ELEDLGLSNVFINK	Fusobacterium periodonticum
FHEAGITVIPVVPSVALAK	Bacteria
VGATPVPHAEILELIKPDLKK	Fusobacterium
VQVEHPVTEFVSGVDIVK	Bacteria
AGQYYINHR	Firmicutes
EGNDLWNEMK	root
AGIDPATLTSFEAVEK	Granulicatella adiacens
AGIICEGANGPITPEADEVLYKK	Fusobacterium
IVAETSTRPVNTSIK	Fusobacterium
VEVTIPLGSITLR	Bacteria
VPHGESGK	Bacteria
LKEIEDEQITLGER	Streptococcus gordonii
NAFAFLRDEEAVAK	Fusobacterium
IYDNGVVQEER	Fusobacterium
NADTTLVVLVPGLGDDIQAIK	Firmicutes
SRSGGGGGGGLGSGGSIR	Hominidae
SAGTSAQVLGQEGK	Firmicutes
KQAADAVAEEAVR	Streptococcus
AIEQQVNEK	Bacteria
DIIRDEAHDATLNVPFK	Fusobacterium
ILVPLEDEIDEK	Veillonella
GVVEALFAK	Streptococcus
RNEELANSGINFIGTGVSGGEK	Bacteria
FGAFMEILPGK	Fusobacteriales
YAWGINFPK	Bacteria
TVQDVINYIEANKK	Fusobacterium
NIAVNSTK	Bacteria
TFAELEELAK	Bacteria
VIESPEDYPNFTIR	Bacilli
MEHDVTSIDTVGK	Granulicatella adiacens
LSEEESVIK	root
FVNVVDILK	Bacilli
KAPSTPWGKPALGLK	Bacteria
QALAQNEQVYNELSQR	Fusobacterium
GLGAGANPQIGEEAAQESREEIIK	Veillonella
DLTPDQEDAIRR	Streptococcus
DGSVTAGNASGLNDGASFLLLASEEAVKK	Fusobacterium
EVLSNKPAK	root
IYGKPIDEYK	Bacteria
TLTNLAAGR	Bacteria
YILGNSYDFNPK	Fusobacterium
AQLVSDVATATGLTK	Lactobacillus
TDIPAFRPGDTVR	Bacteria
IQNAGTEVVEAK	root
LYDGSYHDVDSSETAFK	Bacteria
ILVTGGAGYIGTHTVVELIK	Streptococcus gordonii
FLSQPFFVAEVFNGTPGK	Pasteurellaceae
KEDIPVLANYFLNK	Fusobacterium
YGIDISNVNSYETLEPVLK	Streptococcus gordonii
LQPGTTPEVQNAVR	Veillonella
VLNSAIANAENNFGLEK	Streptococcaceae
NFLYQTAHQPEPAK	Granulicatella adiacens
LVGIVPILTSYIAHR	Streptococcus
GPALFVPK	Veillonella
NVEIIEDDKQGIIR	Bacteria
CVHCMNCISR	Veillonella
AKFDDLTR	root
PIGPFYSEEEAKAEAEK	Streptococcus
VLELLGQVGIPNPQR	Granulicatella adiacens
KVVITAPGGSDVK	Lactobacillales
EISATELTQATLEDIK	Bacteria
SLAFTEDFK	Streptococcus
NLKPETGHEFDLGVHHK	Veillonella
VSGAGAADYAETHEQPNVDAELAAAAK	Veillonella
VEPSIAALAK	Streptococcus
TITIDPGHGGSDSGAIGPHGVQEK	Veillonella
RDPSMEVQVLQIK	Veillonella
GAPEGWVAPVKR	Bacteria
AAFIEENR	Bacteria
DIYQRPANLFVATFIGK	Fusobacterium
TDDFQNLAR	Veillonella
VTSQAAIQELGK	Granulicatella adiacens
SMEVLNLLNTNPELLNGLVYGPEGK	Bacteria
VLVIASDIAK	Bacteria
GQVLAKPGSIKPHTK	root
DLVDNGGVIK	Fusobacterium
LIESYGEEAK	Granulicatella adiacens
EITPYSSLEDIR	Fusobacterium periodonticum
MYAGFATAEESNK	Bacteria
QEGGVVLTGGVK	Fusobacterium
VYGAPAVIESLVMYYNK	Bacteria
TMVNNVLSMDKDDVATYEK	Streptococcus
QVIADLHALGIK	Veillonella
TPNIYETIRPLR	Fusobacterium periodonticum
EAQELLADAYGVK	Fusobacterium
VAFNQAVDSVR	Bacteria
GAAQNIIPSSTGAAK	root
GGLVPTNFLIQDEYDR	Bacteria
GLDIVIVTTANTDEESR	Bacteria
IVHLPTNIK	Bacteria
NLEEAQQIDAQR	Streptococcus gordonii
VSGGLHGVGISVVNALSEWTK	Bacteria
VAIETEELK	Bacteria
IITHPNFNGNTLDNDIMLIK	Sus scrofa
KAIETIFNVK	Bacteria
NSIQYLQTCEDIER	Bacteria
FLDYSGEIR	Streptococcus
QASNYGVPR	Bacteria
ILGLNNVLIER	Veillonella
EASFENLYDK	Streptococcus
SENISFYTR	Bacteria
IADQISDAVLDAIIEKDPTAR	Veillonella
YFVFESDEYER	Bacteria
DIDEEVETLDELKEK	Bacteria
QYGGAGGDNLMYAMAVEELSK	Fusobacterium
SDDNVVDADYTVVDDDKK	Veillonella
DAQIIDELTGER	Bacteria
FLSYINGVLADLR	Pasteurellaceae
SAGTLPANAALCK	Streptococcus
NIALIPYTR	Fusobacteriaceae
WTPGIYNK	Fusobacterium
KFEDACAR	Bacteria
YCINSASLR	root
VVVDPISR	Bacteria
LKPGFEAPVCIVTSLGTDPSEPSR	Veillonella
ENDRIENEYVGALLDK	Fusobacterium periodonticum
MPDLNASSVETAMK	Bacteria
LYQALTHDKK	Bacteria
ENPDLDLNK	Fusobacterium
EMSIIALAQGR	Bacteria
AVVSLVDLR	Bacteria
DGVPSIMNPDDK	Bacteria
LGIPYITINGR	Fusobacterium
SGGVTMSHLR	root
VLHEDFTGEK	Streptococcus
VAVIGPGSWGTALSQVLNDNGHEVR	Streptococcus
SKPHVNVGTIGHVDHGK	root
TYHGHGVDKK	Bacteria
ANLKPQAK	Haemophilus
VQASIQEDQVR	Bacteria
LGFHDADVDAWFVK	Veillonella
VIKGEAVEAK	Bacteria
TEHLHHAVGQCYR	Fusobacterium
NPILIGILK	Bacteria
TNLPSICGR	Bacteria
MYQIGDKPDNLDELLENANK	Bacteria
VDLIFQSIAGSEK	Fusobacterium
ALLQVDPDFRDSLK	Bacteria
APDVLMAPYDR	Streptococcus
LLFLDEPTSGLDPSTSR	Streptococcus
ISGLEVIDDSTMK	Bacteria
GINDSVPVMK	Fusobacterium
MTGIVEVIGR	Fusobacterium
SLGSNTPVNMVR	Bacilli
EIVAFPGESAEEK	Veillonella
INNLDNVGK	Veillonella
ETGFDLDLLK	Fusobacterium periodonticum
FEEADEALGYSISK	Veillonella
VIDLLAPYLK	root
AIGVMLEDR	Bacteria
GYEEFVIPDDVGGR	Fusobacterium
EVVLCGWVER	Veillonellaceae
IVVNGAGAAGANIAR	Veillonellaceae
IATLLDKPEGR	Bacteria
AALDAVEGGSHNYGEVK	Streptococcus gordonii
IPVLSAHSESVYIETK	Bacteria
SSESGDKNVTVYVEEQYK	Streptococcus gordonii
SLVDHGYVTDFEAFK	Streptococcus gordonii
TYENLTTYNPGEIEGK	Veillonella
AAAANIVPNTTGAAK	Bacteria
VEVMEYDDLKK	Fusobacterium
SGQYYVNHR	Bacteria
QPGSSIMPGK	root
NIESGVAHIR	Bacteria
KFANIGDVIVASVK	Bacteria
ALADLTDLFDMK	Granulicatella adiacens
YIFVTGGVVSSIGK	root
NQAVIDGLAATAK	Streptococcus parasanguinis
HQNAAAAAYLAQVK	Streptococcus
SDALYLVQNSVK	Streptococcus parasanguinis
TDSGIEKVEDLK	Fusobacterium
SGDQLAGVAAESAEER	Streptococcus
SQAMPGAVEFLNEVHK	Veillonella
EPSLGPVFGMK	root
ENLPDGFQK	Bacteria
ALLNNMVIGVSEGFKK	Bacteria
RVDIPSYR	root
SNVPALEACPQK	root
GTLETIADIVAK	Veillonella
GHIEGDQLYLEHNNNPK	Veillonella
EIHLWFPEYK	Veillonella
LILVTAITPTPAGEGK	root
FVSLAHASNVLGVINPIK	Bacteria
QVGADVLVATDPDADRVGVEVLQK	Bacteria
LNDLEDALQQAK	Mammalia
AIGPEPWNAAYVEPSR	Bacteria
TSDWDKVNQALK	Streptococcus gordonii
KGAGISENYTVR	Bacteria
LAEEIAGQK	Streptococcus
NSVTEEISK	Veillonella
FSGYEDGTLPAGTAK	Veillonella parvula
IAVEYFTELLK	Fusobacterium
VLGNGELNK	Bacteria
IVAQNAAVK	Granulicatella adiacens
HPNPQFEGQTK	root
YFTDVANATAYVNLK	Granulicatella adiacens
LIGGAEDILR	Fusobacterium
EKPFDDIEVR	Fusobacterium
TLAISNVLGSTITR	Fusobacterium
YIGNAMIETK	Fusobacterium
FDEHMKPQPWIASK	Veillonella dispar
FYEEDPIYR	Bacteria
EATSANLATLSGQK	Granulicatella adiacens
LALTLGFSHPVEMEAPAGITIDVPAPNK	Veillonella
SHPFYTGEQR	Fusobacterium
VEYTEEYLSLEK	Fusobacterium periodonticum
TPPAAVLLK	root
VFFAFTNSETGK	Fusobacterium
SVHVIPRPHTDTEK	Fusobacterium
VVNYNTAR	Fusobacterium
KLDLAEELKER	Streptococcus
LINVSLPR	Bacteria
GKEDPYLVNAGGGYITAAK	Fusobacterium
TQLQDAVPMTVGQEFK	Bacteria
NISAQESDLPADVDLAK	Streptococcus gordonii
MLNGAGLATPK	Veillonella
LLDPPVHEFLPK	root
QVAGVHTAEQIK	Bacteria
NGTDELQFSK	Bacteria
MQNVQVANLEEIAYR	root
LGIDPQFPSVHQVK	Streptococcus gordonii
VSNLPLIPEVPLPQVLEK	Streptococcus
SHVAGTIK	Bacteria
FGDGGADILPLYR	Bacteria
QYVGTPDPVTVK	Lactobacillales
AVISVGTGTSGPAR	Fusobacterium
YGHAVANAVVSK	Fusobacterium
LEHVNVAQLEEYIK	Streptococcus
NEVLVPAVAK	Veillonella
IEEMLYETAQYK	Veillonella
NIMWYGEDR	Veillonella
